1000000000000001
0000000000000000
00000P0000000000
0000000000001000
0001100000000000
0000000000000000
0000000001100000
0000000000000000
0000000000000000
0000000000000000
0000000000000000
0001000000001000
0000000000000000
0000010000100000
0000000E00000000
1000000000000001